R 1500 800
F 150, 102, 240
C 0, 56, 204

NO ./cont/walls/circuit.xpm
WE ./cont/walls/panel.xpm
EA ./cont/walls/plate.xpm
SO ./cont/walls/rusted.xpm


111111111111111111111
100000000000000000001
100000000000000000001
111111111011111111111
100000000000000000001
100000000000000000001
100000000000000000001
100000000N00000000001
100000000000000000001
100000000000000000001
111111111111111111111
