R 10000 10000

F 0, 102, 51
C 0, 204, 204

NO ./cont/walls/N.xpm
WE ./cont/walls/dark_oak_log.xpm
EA ./cont/walls/S.xpm
SO ./cont/walls/bookshelf.xpm

S ./cont/obj/orc07.xpm

111111111111111111
100000000000200001    1111
100001110000001001    1001
100201000002000001    1111
100001000000000001
1000000000N0011001
100000000000000001
111111111111111111
